[
["壁","壁","壁","壁","壁","黒板","黒板","黒板","黒板","黒板","壁","壁","壁","壁","壁"],
["壁","　","　","　","　","　","　","　","　","　","　","　","　","　","壁"],
["壁","　","　","　","　","　","教卓","教卓","　","　","　","　","　","　","扉"],
["壁","　","　","　","　","　","　","　","　","　","　","　","　","　","壁"],
["壁","　","机","机","　","机","机","　","机","机","　","　","　","　","壁"],
["壁","　","　","　","　","　","　","　","　","　","　","　","　","　","壁"],
["壁","　","机","机","　","机","机","　","よ","机","　","机","机","　","壁"],
["壁","　","　","　","　","　","　","　","　","　","　","　","　","　","壁"],
["壁","　","机","机","　","机","机","　","机","机","　","A","特別机","　","壁"],
["壁","　","　","　","　","　","　","　","　","　","　","　","　","　","壁"],
["壁","　","机","机","　","机","机","　","机","机","　","机","机","　","壁"],
["壁","　","　","　","　","　","　","　","　","　","　","　","　","　","壁"],
["壁","　","机","机","　","机","机","　","机","机","　","机","机","　","壁"],
["壁","　","　","　","　","　","　","　","　","　","　","　","　","　","壁"],
["壁","　","　","　","　","　","　","　","　","　","　","　","　","　","壁"],
["壁","壁","壁","壁","壁","壁","壁","壁","壁","壁","壁","壁","壁","壁","壁"]
]
